11111111111111111111111
10000000000022222222221
10000011000000000000001
11111001211111112111111
10010100001000100000001
10010001002001000000001
10010101011111110111111
10000100000000012200001
10010101000110000001101
10000001011111111211111
10000000000000000001001
11111111111111111111111