1111111111111111111111111111111111111111111111111111111111111111
1000000000111111100000001111110000000001111000110000001111110001
1110111101111111111101111111111111211111110110111101101111111111
1000000000000000000000000000000000000000000000000000000000000001
1111111101111111111110111111111111111112111111011111110111111111
1000000000000000000000000000000000000000000000000000000000000001
1111111111011111111111111111111011111101111101111111001111111111
1000000000000000000000000000000000000000000000000000000000000001
1111111111011111111111111111110111111101111111011111111111111111
1000000000000000000000000000000000000000000000000000000000000001
1111111111111211111111111111111111111121111111111111111111111111
1000000000000000000000000000000000000000000000000000000000000001
1111111111111112111111111110111111110101111110111111111111111111
1000000000000000000000000000000000000000000000000000000000000001
1111111111111111111111111111111111111101111111111111111111111111
1000000000000000000000000000000000000000000000000000000000000001
1111110111111111101111111110111111111101111101111111111111111111
1000000000000000000000000000000000000000000000000000000000000001
1111111111111111111111111111111111111111111111111111111111111111
